"filename", "language", "Dart", "comment", "blank", "total"
"c:\Users\EK\Desktop\untitled2\lib\core\networking\api_constants.dart", "Dart", 1, 1, 1, 3
"c:\Users\EK\Desktop\untitled2\lib\core\networking\api_service.dart", "Dart", 7, 1, 1, 9
"c:\Users\EK\Desktop\untitled2\lib\core\networking\api_service.g.dart", "Dart", 29, 0, 1, 30
"c:\Users\EK\Desktop\untitled2\lib\features\quiz\add quiz questions\data\models\add_quiz_questions_request_body.dart", "Dart", 29, 0, 10, 39
"c:\Users\EK\Desktop\untitled2\lib\features\quiz\add quiz questions\data\models\add_quiz_questions_request_body.g.dart", "Dart", 33, 4, 7, 44
"c:\Users\EK\Desktop\untitled2\lib\features\quiz\add quiz questions\data\models\add_quiz_questions_response.dart", "Dart", 36, 0, 9, 45
"c:\Users\EK\Desktop\untitled2\lib\features\quiz\add quiz questions\data\models\add_quiz_questions_response.g.dart", "Dart", 32, 4, 7, 43
"c:\Users\EK\Desktop\untitled2\lib\features\quiz\add quiz questions\data\repo\add_quiz_questions_repo.dart", "Dart", 20, 0, 3, 23
"c:\Users\EK\Desktop\untitled2\lib\features\quiz\add quiz questions\logic\cubit\add_quiz_questions_cubit.dart", "Dart", 7, 0, 3, 10
"c:\Users\EK\Desktop\untitled2\lib\features\quiz\add quiz questions\logic\cubit\add_quiz_questions_state.dart", "Dart", 5, 0, 2, 7
"c:\Users\EK\Desktop\untitled2\lib\features\quiz\add quiz questions\ui\add_quiz_questions.dart", "Dart", 9, 0, 3, 12
"c:\Users\EK\Desktop\untitled2\lib\features\quiz\add quiz questions\ui\widgets\add_quiz_questions_and_choices_form.dart", "Dart", 0, 0, 1, 1
"c:\Users\EK\Desktop\untitled2\lib\features\quiz\create quiz\ui\widgets\create_quiz_bloc_listener.dart", "Dart", 3, 0, 0, 3
"Total", "-", 211, 10, 48, 269